111111111111111111
1P0000000000000001
100011111110000001
100000000C00011101
1000111111100000C1
100000000000000101
1111111110000000E1
111111111111111111