1111111111111
1P0000C000001
1000C000000E1
1111111111111
