111111111111111111111111
1P0001000C00000000100E11
101101011111111110101C11
101101000000C00000101C11
101101111110111110101C11
10110000000000C000101C11
101111111101111110101C11
1000000C00C0000000101C11
111111111111111110101C11
1C0000000000000000000C11
111111111111111111111111