11111111111111111111
1P000000001000000001
10111110001011111001
10C00000001000C00001
10111111111011111101
1000C000000000000C01
10111111111111111101
100000000C0000000001
1111111111111000E001
11111111111111111111
