1111111111111
1P000000000E1
1000C00000001
1111111111111
