1111111111111
1P000000000E1
1000C00C00001
1111111111111
