1111111111111111111111
1P00000000C000010C0001
1011111111111101111101
1010000C00000000000101
1010111111111111110101
101000000C000000000101
1011111111111111111101
1000000C00000C00000001
1111111111111110111111
1E0000C0000000000C0001
1111111111111111111111
