1111111111111
1P00000C000E1
100C100000001
1111111111111
