1111111111111
100100000P001
1000011111001
1C001100E0001
1111111111111