11111111111111111111111111111111
1P00010000N001C000000000000C0001
10111011111101111111111101010101
1011101000000000000C00000000C101
10111010111111101111111111101011
1000001010000C0000000C00000C0101
10111110101111101111111111101011
1010C00010100000C00000N0000C0101
10101111101011111011111111101011
101000C0001N0000000C000000000101
10111111111111111011111111101011
100000000C000000C00C0000C0000E11
11111111111111111111111111111111